######x#############
#.....U............#
#.....W............#
#.....W....________#
#.....W...........Rx
#.....W............#
#.....W............#
#...GGGGGGGWWWWWWWW#
#...GKKKKKG........#
#...GKKKKKG........#
#...GKKKKKG........#
#...GKKKKKG........#
#...GKKKKKG........#
#...GKKKKKG........#
#...GGGGGGG........#
#..................#
#..................#
#..................#
#................D.#
#################x##
