##############C#####
#............#U#...#
#.....###....#.#...#
#.....#.#....#.#...#
#.....#.######.#...#
#...GGG........#...#
#...W......#####...#
#...#......#.......#
#...W......#.......#
#...#......G.......#
#...W......#.......#
#...#......G...G####
#...W......#GWGW.K.#
#...#..............#
#...WGWGWGWGW......#
#...........#......#
#...WGWGWGWGW......#
#...#..............#
#...#.D............#
######x#############
