######x#############
#K...WU............#
#....G....___......#
#....W.............#
#....G.........._.Rx
#....W..........W..#
#....GWGWGWGWGWGW..#
#......W...W.......#
##.....W...W.......#
##.....W...W.......#
##.....WWWWW....G__#
##..____........G..#
##................W#
#............G_G...#
#.G#####G..........#
#..G###G...........#
#..#G#G#.......GGG.#
#..##G##.......WWW.#
#.........___......#
####################
