####################
#.................K#
#..WGWGWGWG........#
#..GWGWGWGW........#
#..WGWGWGWG..._____#
#..GWGWGWGW..._____#
#..WGWGWGWG..._____#
#..GWGWGWGW........#
#..WGWGWGWG..._____#
#..GWGWGWGW........#
#..WGWGWGWG..._____#
#..GWGWGWGW........#
#..WGWGWGWG..._____#
#..GWGWGWGW........#
#..WGWGWGWGWGWG...RC
#......GWGWGW#######
#.......GWGWG#######
#........GWGW#######
#.............D....#
##############x#####
