####################
#.WWWW.G...G.##....#
#.W....GG..G.##.#..#
#.WWWW.G.G.G.##..#.#
#.W....G..GG.##..#.#
#.WWWW.G...G.####..#
#..................#
#W#G#W#G#W#G#W#G#W##
#..................#
#..................#
#__________________#
#..................#
#..................#
#..................#
#.................Rx
#..................#
#..................#
#..................#
#..................#
####################
