####################
#..................#
#..................#
#_______________...#
#WWWWWWWWWWWWWW....#
#GGGGGGGGGGGGG.....#
#.___________.....Rx
#..WWWWWWWWW.......#
#...GGGGGGG........#
#...._____.........#
#.....WWW..........#
#......_...........#
#.....WWW..........#
#...._____.........#
xL..GGGGGGG........#
#..WWWWWWWWW.......#
#.....________.....#
#......WWWWWWWWW...#
#..................#
####################
