####################
#..W..._...........#
#..#........#......#
#..G........W......#
#..W..._....G......#
#..#........#...___#
xL.G........W......#
#..W........G......#
#..#..._....#......#
#..G........W......#
#..W........G___...#
#..#..._....#......#
#..G........W......#
#..W........G......#
#..#...._...#...___#
#..G........W......#
#...........G......#
#____________......#
#.............D....#
##############x#####
