####################
#....#...W...G.....#
#....#...WK..G.....#
#....#...W...G.....#
CL.......W........Rx
#WGWG#...W...G.....#
#....#...W...G.....#
#....#...W...G.....#
#.__.#...W...G.....#
#.....#.W.W.G......#
#.....#.W.W.G......#
#.....#.W.W.G......#
#.....#.W.W.G......#
#K....#.W.W.GGGGGGG#
#..................#
#......#W#W#W#W#W#W#
#.__...#...........#
#.__...#...........#
#.....D#...........#
######x#############
