##############C#####
#K.W.....W....U....#
#..W..G..W____.....#
#..W..G..W.........#
#..W..G..W.........#
#..W..G..W...______#
#..W..G..W.........#
#..W..G..W.........#
#..W..G..W_____....#
#..W..G..W.........#
#..W..G..W.........#
#..W..G..W...______#
#..W..G..W.........#
#..W..G..W____.....#
xL.W..G..W.........#
#..W..G..W.........#
#..W..G..W...._____#
#..W..G..W.........#
#.....G............#
####################
