######x#############
#.....UG...........#
#......GGGGGGGG..K.#
#.............WW...#
#.............WW...#
#.............WW...#
xL............WW...#
#.............WW...#
#..#######....WW...#
#...GGGGGGGGGGGW...#
#..............W...#
#....._____....W...#
#..............W...#
#____..........W...#
#..............W...#
#..............W...#
#...WWWWWWWWWWWW...#
#..................#
#..............D...#
###############C####
