###############x####
#..____......G.U.G.#
#............W...W.#
#GWGWGWGWGWGWG...G.#
#...............GW.#
#...............G..#
#.....__________G..#
#...............G..#
#...............G..#
#_________......G..#
#...............G..#
#...............G..#
#...............G..#
#......_________G..#
#...............G..#
#...............G..#
#...............G..#
#......#W#W#W#W#W..#
#......W...........#
#####Q##############
