####################
#GGG....WK......#..#
#.....G.........#..#
####..G.######..#..#
xL....G......#.._..#
#G#WW###GG#..#.....#
#.........#.W#.....#
#.._......#..#.....#
#.K...._..#G.#.....#
#GG.......#..#.....#
#.........#.W#.....#
#.........#..#.....#
#____.....#W@#..._.#
#.......WW####.....#
#.................RC
#........#W#W#W....#
#..#............___#
####..___...G......#
#...D..............#
####C#######Q#######
